11111111111111111111111
1P00000C0000C000000E11111111111111111111111111111111111
11111111111111111111111
