111111111
100C0C001
1000000P1
100000001
111110001
100E00CC1
111111111